11111
100E1
1PCC1
10001
10001
10001
10001
10001
10001
10001
11111
