1111111\n1P0C0E1\n1000001\n1C0C0C1\n1111111